data,stato,codice_regione,denominazione_regione,lat,long,ricoverati_con_sintomi,terapia_intensiva,totale_ospedalizzati,isolamento_domiciliare,totale_positivi,variazione_totale_positivi,nuovi_positivi,dimessi_guariti,deceduti,totale_casi,tamponi,casi_testati,note_it,note_en
2020-07-28T17:00:00,ITA,13,Abruzzo,42.35122196,13.39843823,14,1,15,92,107,-7,1,2790,472,3369,125542,82644,,
2020-07-28T17:00:00,ITA,17,Basilicata,40.63947052,15.80514834,2,0,2,45,47,0,0,374,28,449,46282,45492,,
2020-07-28T17:00:00,ITA,18,Calabria,38.90597598,16.59440194,3,0,3,80,83,5,5,1072,97,1252,117706,115672,,
2020-07-28T17:00:00,ITA,15,Campania,40.83956555,14.25084984,27,4,31,362,393,28,29,4128,434,4955,326098,167057,,
2020-07-28T17:00:00,ITA,08,Emilia-Romagna,44.49436681,11.341720800000001,72,3,75,1384,1459,3,20,23830,4286,29575,625962,379540,,
2020-07-28T17:00:00,ITA,06,Friuli Venezia Giulia,45.6494354,13.76813649,7,2,9,103,112,0,0,2918,345,3375,243893,123405,,
2020-07-28T17:00:00,ITA,12,Lazio,41.89277044,12.48366722,194,9,203,739,942,-2,10,6773,862,8577,409189,337657,,
2020-07-28T17:00:00,ITA,07,Liguria,44.41149315,8.9326992,27,0,27,182,209,-1,3,8402,1566,10177,184178,98525,,
2020-07-28T17:00:00,ITA,03,Lombardia,45.46679409,9.190347404,151,13,164,6514,6678,-47,53,72528,16802,96008,1271875,763406,,
2020-07-28T17:00:00,ITA,11,Marche,43.61675973,13.5188753,4,0,4,116,120,8,11,5731,987,6838,163868,98242,,
2020-07-28T17:00:00,ITA,14,Molise,41.55774754,14.65916051,1,0,1,24,25,0,0,421,23,469,27168,26017,,
2020-07-28T17:00:00,ITA,21,P.A. Bolzano,46.49933453,11.35662422,7,0,7,78,85,-9,2,2315,292,2692,102095,52364,,
2020-07-28T17:00:00,ITA,22,P.A. Trento,46.06893511,11.12123097,1,0,1,93,94,0,0,4467,405,4966,149099,71558,,
2020-07-28T17:00:00,ITA,01,Piemonte,45.0732745,7.680687483,136,5,141,660,801,-1,12,26694,4127,31622,490394,300716,,
2020-07-28T17:00:00,ITA,16,Puglia,41.12559576,16.86736689,15,0,15,67,82,3,4,3963,551,4596,233247,160386,,
2020-07-28T17:00:00,ITA,20,Sardegna,39.21531192,9.110616306,5,0,5,16,21,6,6,1237,134,1392,104201,88391,,
2020-07-28T17:00:00,ITA,19,Sicilia,38.11569725,13.362356699999998,29,2,31,175,206,12,19,2726,283,3215,267962,211860,,
2020-07-28T17:00:00,ITA,09,Toscana,43.76923077,11.25588885,13,0,13,350,363,0,3,8944,1134,10441,414464,275553,,
2020-07-28T17:00:00,ITA,10,Umbria,43.10675841,12.38824698,7,1,8,9,17,0,0,1368,80,1465,118369,76851,,
2020-07-28T17:00:00,ITA,02,Valle d'Aosta,45.73750286,7.320149366,1,0,1,10,11,10,10,1049,146,1206,21176,15399,,
2020-07-28T17:00:00,ITA,05,Veneto,45.43490485,12.33845213,33,0,33,721,754,20,24,17026,2069,19849,1191525,476975,,
